NO ./textures/wall2-_1_.xpm      
WE ./textures/wall3.xpm
SO ./textures/flowers.xpm
EA ./textures/frost.xpm
F 0,1,1



C 250,0,112

111111

