NO ./path_to_the_north_texture          
WE ./path_to_the_west_texture
SO ./path_to_the_south_texture
EA ./path_to_the_east_texture

F 0,237,250

C 250,0,112      

1111111
1000001
100S001
1111111

