NO ./path_to_the_north_texture          
WE ./path_to_the_west_texture
SO ./path_to_the_south_texture
EA ./path_to_the_east_texture

F 0,237,250

C 250,0,112      

111111111111111111111111111
100000000000000000000000001
100000000000000000000000001
100000000000000000000000001
100000000000000000000000001
100000010000000000000000001
100000000000000000000000001
1000000100000W0000000000001
100000000000000000000000001
100000010000000000000000001
100000000000000000000000001
100000001000000000000000001
100000000000000000000000001
100000000000000000000000001
111111111111111111111111111