NO textures/walls/wallN.xpm      
WE textures/walls/wallW.xpm
SO textures/walls/wallS512.xpm
EA textures/walls/wallE.xpm

F 128,128,128

C 255,255,255


1111111111
1100S00101
1000000001
1000000001
1100000001
1111111111