NO textures/walls/wallN.xpm      
WE textures/walls/wallW.xpm
SO textures/walls/wallS512.xpm
EA textures/walls/wallE.xpm

F 128,128,128

C 0,0,0

111 111
1111111111
1000ED1001
1001010101
1000000D01
1001000101
1111111111