NO ./textures/wall2-_1_.xpm      
WE ./textures/wall3.xpm
SO ./textures/flowers.xpm
EA ./textures/frost.xpm

F 0,237,250

C 250,0,112

111111111111111111111111111
100000000000000000000000S01
100000000000000000000000001
100000000000000000000000001
100000000000000000000000001
100000010000000010000000001
100000000000000000000000001
100000010000000000000000001
100000000000000000000000001
100000010000000000000000001
100000000000000000000000001
100000001000000000000000001
100000000000000000000000001
100000000000000000000000001
111111111111111111111111111