C 255,255,255
SO textures/walls/wallN.xpm
EA textures/walls/wallE.xpm
WE textures/walls/wallW.xpm
NO textures/walls/wallS512.xpm          
F 255,168,128


1111111111
1100000101
1000000001
1001010001111
11000000011S1
11111111111111